###############
#F            #
####          #
#             #
#   $$    $   #
#   $$        #
#             #
#             #
#~~~~~ ~~~~~~~#
#~~~~~ ~~~~~~~#
#             #
#  ###        #
#            S#
###############
